8 8
12 5 5 5 13 9 12 9
10 12 9 12 3 6 3 10
6 3 10 6 5 5 9 10
8 4 7 5 9 12 3 10
10 12 5 9 10 10 8 10
6 3 8 10 2 10 6 11
12 5 3 6 9 6 9 10
6 5 21 5 7 5 3 34